1111112222222222222222222222222222222222222211111
1111110000000000000000000000000000000000000011111
1111110000000000000000000000000000000000000011111
111111300000000000000000000000000000000000011111
2222222222222222220000000000000000000022200011111
1111110000000000000000002222000000000000000011111
1111110000000000000000000000000000000000400011111
1111110000000022200000000000000000000022200011111
1111110000000000000000000000000000000000000011111
1111110000000000000000002222000000000000000011111
1111110000000000000000000000000000000000000011111
1111110000000022200000000000000000000022200011111
1111110000000000000000000000000000000000000011111
1111110000000000000022222000000000000000000011111
1111110000000000000000000000000000000000000011111
1111110000000222200000000222220000022222200011111
1111110000000000000000000000000000000000000011111
1111110000000000002222222200000000000000000011111
1111110000000000000000000000000000000000000011111
1111110002222220000000000000000000222200000011111
1111110000000000000000000000000000000000000011111
1111110000000000002222200000022222000000000011111
1111110000000000000000000000000000000000000011111
1111110222200000000000000000000000000000000011111
1111110000000000000000000000000000000000000011111
1111110000000222220000000000000000002222220011111
1111110000000000000000002222220000000000000011111
1111110000000000000000000000000000000000000011111
1111110000000000000000000000000000000000000011111
1111110000000000000222000002222222222222222211111
1111111111111111000000000000000000000000000011111
1111110000000000000000000000000000000000000011111
1111110000000000000000000000000000000005000011111
1111112222222222222222222222222222222222222211111
1111111111111111111111111111111111111111111111111
1111111111111111111111111111111111111111111111111

